{
  "id": "fork",
  "name": "Fork",
  "tags": [
    "three-way",
    "hub",
    "ambush"
  ],
  "theme": {
    "floor": "#120c08",
    "grid": "#302018",
    "walls": "#2a1c14",
    "wallStroke": "#886040",
    "accent": "#ffb347"
  },
  "grid": {
    "cols": 32,
    "rows": 18,
    "cell": 40,
    "solid": [
      "################################",
      "#..............................#",
      "#..............................#",
      "#..............................#",
      "#..##........######........##..#",
      "#..##........######........##..#",
      "#..##.....##........##.....##..#",
      "#..##.....##........##.....##..#",
      "#.........##........##.........#",
      "#.........##........##.........#",
      "#..............................#",
      "#....#####............#####....#",
      "#....#####...######...#####....#",
      "#.......##...######...##.......#",
      "#..............................#",
      "#..............................#",
      "#..............................#",
      "################################"
    ],
    "spawn": [
      "................................",
      "................................",
      "................1...............",
      "................................",
      "................................",
      "................................",
      "................................",
      "................................",
      "..4..........................5..",
      "................................",
      "................................",
      "................................",
      "................................",
      "................................",
      "................................",
      ".......2........6........3......",
      "................................",
      "................................"
    ]
  }
}
