{
  "id": "midline",
  "name": "Midline",
  "tags": [
    "horizontal",
    "north-south",
    "symmetric"
  ],
  "theme": {
    "floor": "#100a14",
    "grid": "#241830",
    "walls": "#22182c",
    "wallStroke": "#684878",
    "accent": "#ff4da6"
  },
  "grid": {
    "cols": 32,
    "rows": 18,
    "cell": 40,
    "solid": [
      "################################",
      "#..............................#",
      "#..............................#",
      "#......####...####...####......#",
      "#......####...####...####......#",
      "#..............................#",
      "#..............................#",
      "#..............................#",
      "#.......####........####.......#",
      "#.......####........####.......#",
      "#..............................#",
      "#..............................#",
      "#..............................#",
      "#......####...####...####......#",
      "#......####...####...####......#",
      "#..............................#",
      "#..............................#",
      "################################"
    ],
    "spawn": [
      "................................",
      "................................",
      "..1..........................2..",
      "................................",
      "................................",
      "................................",
      "................................",
      "................3...............",
      "................................",
      "................................",
      "................................",
      "................6...............",
      "................................",
      "................................",
      "...4........................5...",
      "................................",
      "................................",
      "................................"
    ]
  }
}
