{
  "id": "rings",
  "name": "Rings",
  "tags": [
    "rotation",
    "perimeter",
    "medium"
  ],
  "theme": {
    "floor": "#081210",
    "grid": "#142420",
    "walls": "#162820",
    "wallStroke": "#3f7858",
    "accent": "#50ff88"
  },
  "grid": {
    "cols": 32,
    "rows": 18,
    "cell": 40,
    "solid": [
      "################################",
      "#..............................#",
      "#..............................#",
      "#..............................#",
      "#.......################.......#",
      "#.......################.......#",
      "#.......################.......#",
      "#.......################.......#",
      "#.......################.......#",
      "#.......################.......#",
      "#.......################.......#",
      "#.......################.......#",
      "#.......################.......#",
      "#.......################.......#",
      "#..............................#",
      "#..............................#",
      "#..............................#",
      "################################"
    ],
    "spawn": [
      "................................",
      "................................",
      "...............5................",
      "................................",
      "....1......................2....",
      "................................",
      "................................",
      "................................",
      "................................",
      "................................",
      "................................",
      "................................",
      "................................",
      "....3......................4....",
      "................................",
      "...............6................",
      "................................",
      "................................"
    ]
  }
}
