{
  "id": "split",
  "name": "Split",
  "tags": [
    "vertical",
    "two-lane",
    "symmetric"
  ],
  "theme": {
    "floor": "#0a1018",
    "grid": "#182030",
    "walls": "#1a2438",
    "wallStroke": "#4a6888",
    "accent": "#46e9ff"
  },
  "grid": {
    "cols": 32,
    "rows": 18,
    "cell": 40,
    "solid": [
      "################################",
      "#..............................#",
      "#..............##..............#",
      "#...####.......##.......####...#",
      "#...####.......##.......####...#",
      "#......##......##......##......#",
      "#......##..............##......#",
      "#.....#######......#######.....#",
      "#.....#######......#######.....#",
      "#......##..............##......#",
      "#..............................#",
      "#..............##..............#",
      "#..............##..............#",
      "#...####.......##.......####...#",
      "#...####.......##.......####...#",
      "#..............................#",
      "#..............................#",
      "################################"
    ],
    "spawn": [
      "................................",
      "................................",
      "..1..........................2..",
      "................................",
      "................................",
      "................................",
      "................................",
      "................................",
      "................................",
      "................................",
      "..........5..........6..........",
      "................................",
      "................................",
      "................................",
      "................................",
      "..3..........................4..",
      "................................",
      "................................"
    ]
  }
}
